1 1 1 1 0 0 1 1 1 1
1 4 3 3 0 0 3 3 4 1
1 3 2 2 2 2 2 2 3 1
1 4 2 4 4 4 4 2 3 1
1 3 2 2 2 2 2 2 3 1
1 4 1 4 1 1 4 1 4 1
1 3 2 2 2 2 2 2 3 1
1 4 1 4 1 1 4 1 4 1
1 3 2 2 2 2 2 2 3 1
1 4 2 4 4 4 4 2 3 1 
1 3 2 2 2 2 2 2 3 1 
1 4 3 3 0 0 3 3 4 1 
1 1 1 1 0 0 1 1 1 1
